#####
#   ##
#   @#
## $.#
 #   #
 #####