#####
#   ##
#   @#
## $.#
 # $.#
 #####